SO ./textures/south_texture.png

F 220,100,0
WE ./textures/west_texture.png


NO ./textures/north_texture.png
EA ./textures/east_texture.png



C 225,30,0

11111111
10000001
10000001
100100011
10E0000001
100000011
11111111