SO ./textures/south_texture.png
F 204,204,204
WE ./textures/west_texture.png
NO ./textures/north_texture.png
C 153,204,255
EA ./textures/east_texture.png

11111111111111111111111111111
10000000000000001000000000001
10000000000000002000000000001
10000000000000001000000000001
10000000000000001111111111111
10000000000000000000000000001
10000000000000000000000000001
10111111111112100000000000001
10100010001010100000000000001
10201000100010100000000000001
11111111111110111111111111111
10000000000000000000000000001
10000000000000000000000000001
11111112111111111111111111121
10000000001000000000002000001
10000000001000000000001000001
10000000001000000000001000001
10000000002000000000001112111
10000000001000000000001000001
10000000001000000000001000001
1000000000100000000000100N001
11111111111111111111111111111