SO ./textures/south_texture.png
F 204,204,204
WE ./textures/west_texture.png
NO ./textures/north_texture.png
C 153,204,255
EA ./textures/east_texture.png

110101
100001
100101
10E001
100001
111111