NO ./textures/north_texture.png
SO ./textures/south_texture.png
EA ./textures/east_texture.png
WE ./textures/west_texture.png
F 204,204,204
C 153,204,255
1111111111111111111111111111111111111111
1000000000000000000000000000000000001001
1000111100000000000000000000000001000001
1000111100000000000000000000000001111111
1000111100000000000011100000000000000001
1000111100000000000011100000000000000001
1000000000000000000011100000000000000001
1000000000000000000000000000000000000001
1000000000000000000000000000000001111111
1000000000000000000000000000000001111111
100000000000000000N000000000000000000001
1000000000000000000000000000000000000001
1111111111111100000000000000000000000001
1111111111111100000000000000000000000001
1000000000000000000000000111100000000001
1000000000000000000000000111100000000001
1000000000000000000000000111100000000001
1000000000000000000000000000000000000001
1000000000000000000000000000000000000001
1111111111111111111111111111111111111111