NO ./textures/north_texture.png
SO ./textures/south_texture.png
WE ./textures/west_texture.png
EA ./textures/east_texture.png

F 130,130,130
C 150,220,230

        1111111111111111111111111
        1000000000110000000000001
        1011000001110000000000001
        1001000000000000000000001
111111111011000001110000000000001
100000000011000001110111121111111
11110111111111011100000010001
11110111111111011101010010001
11000000110101011100000020001
10000000000000001100000010001
10000000000000001101010020W01
1100000111010101111101111000111
11110111 1110101 101111010001
11111111 1111111 111111111111